..#############
|.....#$......#
|.#.#.###.###.#
|.#.#$#$..#.#.#
|.###$#####.#.#
|.$.#.#...#...#
|..||$###.#.###
|.#||.#.#.#.$.#
|$##|.#.#.###.#
|###|.$...#.$.#
|||||.######.#
|.#...#.#...$.#
|.#.###.#.###.#
|....$......#@#
|||||||||||||||
