|##############
|##############
|##############
|##############
|###$##########
|......@.$.....
|######.#######
|####.#.$.#####
|####.#.#.#####
|####.....$####
|######.#######
|######.#######
|######.#######
|######.#######
|##############
|##############