..#############
#.....#...#...#
#####$###.###.#
#...$.#....$..#
#.#.#.#####.#.#
#.#$#.#.#...#.#
#.#####.###.###
|..$..#...#...#
||#.#####.###.#
|||...#.......#
##|.###.###.###
##|.....#$#.#.#
|||.###.#.#.#.#
|...#...#.....#
|||||||||||||.@
