|##############
|##############
|######$#######
|######$#######
|######$#######
|.@............
|######.#######
|#####...#####
|####.#.#.#####
|####.....#####
|######.#######
|######.#######
|######$#######
|######$#######
|##############
|##############