..#############
....#...#....$#
#.#.#.#.#.#####
#$#...#.#.#..$#
#####.#.#.#.###
#.....#.......#
#.###.#.#.|||$#
#...#.||||||||#
#$###.#||||$|.#
#........##.|.#
#.#####.###.|||
#$#.#...#.....|
###.#.#.#.#.|||
#$....#...#...#
#############.@