###############
#...#.#..#.#..#
#...#..#.#....#
#...#....#..#.#
#.#.#....#....#
#...#....#....#
#.............#
#...#.........#
#..........#..#
#.#...@.......#
#.............#
#...#......#..#
#.............#
#.............#
#######..######