###############
#...#.#..#.#..#
#...#..#.#....#
#...#....#..#.#
#.#.#....#....#
#...#....#....#
#.............#
#...#.........#
#..........#..#
#.#...........#
#..#||||......#
||||||||...#..#
#...||||#.....#
#.............#
#######.@######